80  60
6 30
0  0  0  0  0  0  0  0  0  0  0  0  0  0  0  0  0  0  0  0  0  0  0  0  0  0  0  0  0  0  0  0  0  0  0  0  0  0  0  0  0  0  0  0  0  0  0  0  0  0  0  0  0  0  0  0  0  0  0  0  0  0  0  0  0  0  0  0  0  0  0  0  0  0  0  0  0  0  0  0 
 0  0  0  0  0  0  0  0  0  0  0  0  0  0  0  0  0  0  0  0  0  0  0  0  0  0  0  0  0  0  0  0  0  0  0  0  0  0  0  0  0  0  0  0  0  0  0  0  0  0  0  0  0  0  0  0  0  0  0  0  0  0  0  0  0  0  0  0  0  0  0  0  0  0  0  0  0  0  0  0 
 0  0  0  0  0  0  0  0  0  0  0  0  0  0  0  0  0  0  0  0  0  0  0  0  0  0  0  0  0  0  0  0  0  0  0  0  0  0  0  0  0  0  0  0  0  0  0  0  0  0  0  0  0  0  0  0  0  0  0  0  0  0  0  0  0  0  0  0  0  0  0  0  0  0  0  0  0  0  0  0 
 0  0  0  0  10  10  10  10  10  10  10  10  10  10  10  10  10  10  10  10  10  10  10  10  10  10  10  10  10  10  10  10  10  10  10  10  10  10  10  21  21  21  21  21  21  21  10  10  0  0  0  0  0  0  0  0  0  0  0  0  21  10  10  10  10  10  10  10  10  10  10  10  10  10  10  10  0  0  0  0 
 0  0  0  0  10  10  10  10  10  21  10  10  10  10  21  10  10  10  10  10  10  10  10  10  10  10  10  10  10  10  10  10  10  10  10  10  10  10  10  21  21  21  21  21  21  21  10  10  10  0  0  0  0  0  0  0  0  0  0  0  21  10  10  10  10  10  10  10  10  10  10  10  10  10  10  10  0  0  0  0 
 0  0  0  0  21  21  10  10  10  21  10  10  10  10  21  10  10  10  10  10  10  10  10  10  10  10  10  10  10  10  10  10  10  10  10  10  10  10  10  10  21  21  21  21  10  10  10  10  10  10  0  0  0  0  0  0  0  0  0  0  21  10  10  10  10  10  10  10  10  10  10  10  10  10  10  10  0  0  0  0 
 0  0  0  0  21  21  21  21  10  21  21  10  10  10  21  21  10  10  10  10  10  10  10  10  10  10  10  10  10  10  10  10  10  10  10  10  10  10  10  10  10  10  21  10  10  10  10  10  21  21  21  0  21  0  0  0  0  0  0  0  0  10  10  10  10  10  10  10  10  10  10  10  10  10  21  0  0  0  0  0 
 0  0  0  0  21  21  21  21  21  21  21  21  21  21  21  21  21  10  10  10  10  10  10  10  10  10  10  10  10  10  10  10  10  10  10  10  10  10  10  10  10  10  21  10  10  10  10  21  21  21  21  21  21  0  0  0  0  0  0  0  10  10  10  10  10  10  10  10  10  10  10  10  10  21  21  0  0  0  0  0 
 0  0  0  0  21  21  21  21  21  21  21  21  21  21  21  21  21  10  10  10  10  10  10  10  10  10  10  10  10  10  10  10  10  10  10  10  10  10  10  10  10  10  6034  10  10  10  10  21  21  21  21  21  21  0  0  0  0  0  0  0  10  10  10  10  10  10  10  10  10  10  10  10  21  21  21  0  0  0  0  0 
 0  0  0  0  21  21  21  21  21  21  21  21  21  21  21  21  21  10  10  10  10  10  10  10  10  10  10  10  10  10  10  10  10  10  10  10  10  10  10  10  10  10  6034  10  10  10  10  21  21  21  21  21  21  0  0  0  0  0  0  0  10  10  10  10  10  10  10  10  10  10  10  10  21  21  21  0  0  0  0  0 
 0  0  0  0  21  21  21  21  21  0  0  0  0  21  21  21  21  10  10  10  10  10  10  10  10  10  10  10  10  10  10  10  10  10  10  10  10  10  10  10  10  10  10  10  10  10  10  10  21  21  21  21  10  0  0  0  0  0  0  0  0  10  10  10  10  10  10  10  10  10  10  10  21  21  21  0  0  0  0  0 
 0  0  0  0  21  21  21  21  0  0  0  0  0  0  0  0  21  21  10  10  10  10  10  10  10  10  10  10  10  10  10  10  10  10  10  10  10  10  10  10  10  10  10  10  10  10  10  10  10  21  21  10  10  0  0  0  0  0  0  0  0  10  10  10  10  10  10  10  10  10  10  10  21  21  21  21  0  0  0  0 
 0  0  0  0  10  0  10  0  0  0  0  0  0  0  0  0  21  21  10  10  10  10  10  10  10  10  10  10  10  10  10  10  10  10  10  10  10  10  10  10  10  10  10  10  10  10  10  10  10  21  10  10  10  0  0  0  0  0  0  0  0  10  10  10  10  10  10  10  10  10  10  10  21  21  21  21  0  0  0  0 
 0  0  0  0  10  0  0  0  0  0  0  0  0  0  0  0  0  0  10  10  10  10  10  10  10  10  10  10  10  10  10  10  10  10  10  10  10  10  10  10  10  10  10  10  10  10  10  10  10  21  10  10  10  10  0  0  0  10  10  10  10  10  10  10  10  10  10  10  10  10  10  10  21  21  21  21  0  0  0  0 
 0  0  0  0  10  0  0  0  0  0  0  0  0  0  0  0  0  0  10  10  10  10  10  10  10  10  10  10  10  10  10  10  10  10  10  10  10  10  10  10  10  10  10  10  10  10  10  10  10  21  10  10  10  10  10  10  10  10  10  10  10  10  10  10  10  10  10  10  10  10  10  10  21  21  21  21  0  0  0  0 
 0  0  0  0  10  10  0  0  0  0  0  0  0  0  0  0  0  0  10  10  10  10  10  10  10  10  10  10  10  10  10  10  10  10  10  10  10  10  10  10  10  10  10  10  10  10  10  10  10  21  10  10  10  10  10  10  10  10  10  10  10  10  10  10  10  10  10  10  10  10  10  10  10  10  21  21  0  0  0  0 
 0  0  0  0  21  21  0  0  0  0  0  0  0  0  0  0  0  0  10  10  10  10  10  10  10  10  10  10  10  10  10  10  10  10  10  10  10  10  10  10  10  21  21  10  10  10  10  10  10  21  10  10  10  10  10  10  10  10  10  10  10  10  10  10  10  10  10  10  10  10  10  10  10  10  10  21  0  0  0  0 
 0  0  0  0  21  21  0  0  0  0  0  0  0  0  0  0  0  0  10  10  10  10  10  10  10  10  10  10  10  10  10  10  10  10  10  10  10  10  10  10  10  21  21  21  10  10  10  10  10  21  10  10  10  10  10  10  10  10  10  10  10  10  10  10  10  10  10  10  10  10  10  10  10  10  10  21  0  0  0  0 
 0  0  0  0  21  21  21  0  0  0  0  0  0  0  0  0  0  0  10  10  10  10  10  10  10  10  10  10  10  10  10  10  10  10  10  10  10  10  10  10  21  21  21  21  10  10  21  21  10  21  21  10  10  10  10  10  10  10  10  10  10  10  10  21  21  21  21  10  10  10  10  10  10  10  10  21  0  0  0  0 
 0  0  0  0  21  21  21  0  0  0  0  0  0  0  0  0  0  0  10  10  10  10  10  10  10  10  10  10  10  10  10  10  10  10  10  10  10  10  10  10  21  21  21  21  10  21  21  21  21  21  21  21  10  10  10  10  10  10  10  10  10  10  10  21  21  21  21  10  10  10  10  10  10  10  10  21  0  0  0  0 
 0  0  0  0  21  21  21  0  0  0  0  0  0  0  0  0  0  0  10  10  10  10  10  10  10  10  10  10  10  10  10  10  10  10  10  10  10  10  10  10  21  21  21  21  21  21  21  21  21  21  21  21  10  10  10  10  10  10  10  10  10  10  10  21  21  21  21  10  10  10  10  10  10  10  10  10  0  0  0  0 
 0  0  0  0  10  21  21  0  0  0  0  0  0  0  0  0  10  10  10  10  10  10  10  10  10  10  10  10  10  10  10  10  10  10  10  10  10  10  10  10  10  21  21  0  0  21  21  21  21  21  21  21  10  10  10  10  10  10  10  10  10  10  10  21  21  21  21  10  10  10  10  10  10  10  10  10  0  0  0  0 
 0  0  0  0  10  21  10  10  0  0  0  0  0  0  0  0  10  10  10  10  10  10  10  10  10  10  10  10  10  10  10  10  10  10  10  10  10  10  10  10  10  10  0  0  0  0  0  0  0  0  0  0  10  10  10  10  10  10  10  10  10  10  10  21  21  21  21  21  21  21  21  10  10  10  10  10  0  0  0  0 
 0  0  0  0  10  0  10  10  10  0  0  0  0  0  0  10  10  10  10  10  10  10  10  10  10  10  10  10  10  10  10  10  10  10  10  10  10  10  10  10  10  10  0  0  0  0  0  0  0  0  0  0  0  10  10  10  10  10  10  10  10  10  10  10  0  0  21  21  21  21  21  10  10  10  21  21  0  0  0  0 
 0  0  0  0  10  0  10  10  10  10  10  10  10  10  10  10  10  10  10  10  10  10  10  10  10  10  10  10  10  10  10  10  10  10  10  10  10  10  10  10  10  10  0  0  0  0  0  0  0  0  0  0  0  0  10  10  10  10  10  10  10  10  10  10  0  0  0  21  21  21  21  21  21  21  21  21  0  0  0  0 
 0  0  0  0  10  10  10  10  10  10  10  10  10  10  10  10  10  10  10  10  10  10  10  10  10  10  10  10  10  10  10  10  10  10  10  10  10  10  10  21  21  10  0  0  0  0  0  0  0  0  0  0  0  0  10  10  10  10  10  10  10  10  10  0  0  0  0  0  0  21  21  21  21  21  21  21  0  0  0  0 
 0  0  0  0  15  15  15  10  10  10  10  10  10  10  10  10  10  10  10  10  10  10  10  10  10  10  10  10  10  10  10  10  10  10  10  10  10  10  21  21  21  21  10  10  0  0  0  0  0  0  10  10  10  10  10  10  10  10  10  10  10  10  0  0  0  0  0  0  0  0  0  0  21  21  21  21  0  0  0  0 
 0  0  0  0  15  15  15  10  10  10  10  10  21  21  21  10  10  10  10  10  10  10  10  10  10  10  10  10  10  10  10  10  10  10  10  10  10  10  21  21  21  21  10  10  10  0  0  0  0  0  10  10  10  10  10  10  10  10  10  10  10  10  0  0  0  0  0  0  0  0  0  0  0  21  21  0  0  0  0  0 
 0  0  0  0  15  15  15  10  10  10  10  21  21  21  21  21  10  10  10  10  10  10  10  10  10  10  10  10  10  10  10  10  10  10  10  10  10  10  21  21  21  21  10  10  10  10  0  0  0  10  10  10  10  10  10  10  10  10  10  10  10  10  0  0  0  0  0  0  0  0  0  0  0  0  0  0  0  0  0  0 
 0  0  0  0  15  15  15  10  10  10  10  21  21  21  21  21  10  10  10  10  10  10  10  10  10  10  10  10  10  10  10  10  10  10  10  10  10  10  0  0  0  0  10  10  10  0  0  0  0  10  10  10  10  10  10  10  10  21  21  21  21  10  0  0  0  0  0  0  0  0  0  0  0  0  0  0  0  0  0  0 
 0  0  0  0  15  15  15  10  10  10  10  21  21  21  21  21  21  10  10  10  10  10  10  10  10  10  10  10  10  10  10  10  10  10  10  10  10  10  0  0  0  0  10  10  0  0  0  0  0  10  10  10  10  10  10  10  10  21  21  21  21  10  0  0  0  0  0  0  0  0  0  0  0  0  0  0  0  0  0  0 
 0  0  0  0  10  10  10  10  10  10  10  21  21  21  21  21  21  21  21  10  10  10  10  10  10  10  10  10  10  10  10  10  10  10  10  10  10  10  10  0  0  0  0  0  0  0  0  0  0  10  10  10  10  10  10  10  10  21  21  21  21  10  0  0  0  0  0  0  10  10  10  10  0  0  0  0  0  0  0  0 
 0  0  0  0  10  10  10  10  10  10  10  10  21  21  21  21  21  21  21  21  10  10  10  10  10  10  10  10  10  10  10  10  10  10  10  10  10  10  10  10  0  0  0  0  0  0  0  0  0  10  10  10  10  10  10  10  10  21  21  21  21  10  0  0  0  0  0  10  10  10  10  10  0  0  0  0  0  0  0  0 
 0  0  0  0  10  10  10  10  10  10  10  10  0  0  0  0  0  0  21  21  10  10  10  10  10  10  10  10  10  10  10  10  10  10  10  10  10  10  0  0  0  0  0  0  0  0  0  0  0  10  10  10  10  10  10  10  10  21  21  21  21  10  10  10  0  0  0  10  10  10  10  10  10  10  10  10  0  0  0  0 
 0  0  0  0  10  10  10  10  10  10  10  10  0  0  0  0  0  0  0  21  21  21  10  10  10  10  10  10  10  10  10  10  10  10  10  10  10  0  0  0  0  0  0  0  0  0  0  0  0  10  10  10  10  10  10  10  10  10  0  0  0  10  10  0  0  0  0  10  10  10  10  10  10  10  10  10  0  0  0  0 
 0  0  0  0  10  10  10  10  10  10  10  10  0  0  0  0  0  0  0  21  21  21  21  10  10  10  10  10  10  10  10  10  10  10  10  21  21  21  0  0  0  0  0  0  0  0  0  0  0  10  10  10  10  10  10  10  10  10  0  0  0  10  0  0  0  0  0  10  10  10  10  10  35  35  35  35  0  0  0  0 
 0  0  0  0  10  10  10  10  10  10  10  10  0  0  0  0  0  0  0  21  21  21  21  10  10  10  10  10  10  10  10  10  10  10  21  21  21  21  0  0  0  0  0  0  0  0  0  0  0  10  10  10  10  10  10  10  10  0  0  0  0  0  0  0  0  0  0  10  10  10  10  10  35  35  35  35  0  0  0  0 
 0  0  0  0  10  10  10  10  10  10  10  10  0  0  0  0  0  0  0  0  0  0  0  0  10  10  10  10  10  10  10  10  10  10  21  21  21  21  0  0  0  0  0  0  0  0  0  0  0  10  10  10  10  10  10  10  0  0  0  0  0  0  0  0  0  0  0  10  10  10  10  10  35  35  35  35  0  0  0  0 
 0  0  0  0  10  10  10  10  10  10  10  10  0  0  0  0  0  0  0  0  0  0  0  0  10  10  10  10  10  10  10  10  10  21  21  21  21  21  0  0  0  0  0  0  0  0  0  0  10  10  10  10  10  10  10  10  0  0  0  0  0  0  0  0  0  0  0  10  10  10  10  10  35  35  35  35  0  0  0  0 
 0  0  0  0  10  10  10  10  10  10  10  10  0  0  0  0  0  0  0  0  0  0  0  0  0  10  10  10  10  10  10  10  21  21  21  21  21  21  0  0  0  0  0  0  0  0  0  0  10  10  10  10  10  10  10  10  0  0  0  0  0  0  0  0  0  0  0  10  10  10  10  10  35  35  35  35  0  0  0  0 
 0  0  0  0  10  10  10  10  10  10  10  10  0  0  0  0  0  0  0  0  0  0  0  0  0  0  10  10  10  10  10  10  21  21  21  21  21  0  0  0  0  0  0  0  0  0  0  0  10  10  10  10  10  10  10  10  0  0  0  0  0  0  0  0  0  0  0  10  10  10  10  10  10  10  10  10  0  0  0  0 
 0  0  0  0  10  10  10  10  10  10  10  10  0  0  0  0  0  0  0  0  0  0  0  0  0  0  10  10  10  10  10  21  21  21  21  21  0  0  0  0  0  0  0  0  0  0  0  10  10  10  10  10  10  10  10  10  0  0  0  0  0  0  10  10  10  10  10  10  10  10  21  21  21  10  10  10  0  0  0  0 
 0  0  0  0  10  10  10  10  10  10  10  10  0  0  0  0  0  0  0  0  0  0  0  0  0  0  10  10  10  10  10  21  21  21  21  0  0  0  0  0  0  0  0  0  0  0  10  10  10  10  10  10  10  10  10  10  0  0  0  0  10  10  10  10  10  10  10  10  10  21  21  21  21  10  10  10  0  0  0  0 
 0  0  0  0  10  10  10  10  10  10  10  10  0  0  0  0  0  0  0  0  0  0  0  0  0  0  10  10  10  10  10  21  21  21  0  0  0  0  0  0  0  0  0  0  0  21  21  10  10  10  10  10  10  10  10  10  10  10  10  10  10  10  10  10  10  10  10  10  10  21  21  21  21  10  10  10  0  0  0  0 
 0  0  0  0  10  10  10  10  10  10  10  10  0  0  0  0  0  0  0  0  0  0  0  0  0  0  10  10  10  10  10  0  0  0  0  0  0  0  0  0  0  0  0  0  21  21  21  10  10  10  10  10  10  10  10  10  10  10  10  10  10  10  10  10  10  10  10  10  0  0  0  0  0  10  10  10  0  0  0  0 
 0  0  0  0  10  10  10  10  10  10  10  10  10  0  0  0  0  0  0  0  0  0  0  0  0  0  10  10  10  10  0  0  0  0  0  0  0  0  0  0  0  0  0  21  21  21  21  10  10  10  10  10  10  10  10  10  10  10  10  10  10  10  10  10  10  10  10  0  0  0  0  0  0  0  10  10  0  0  0  0 
 0  0  0  0  10  10  10  10  10  10  10  10  10  10  0  0  0  0  0  0  0  0  0  0  0  0  10  10  10  10  0  0  0  0  0  0  0  0  0  0  0  0  21  21  21  21  21  10  21  10  10  10  10  10  10  10  10  10  10  10  10  10  10  10  10  10  10  0  0  0  0  0  0  0  0  0  0  0  0  0 
 0  0  0  0  10  10  10  21  21  10  10  10  10  10  0  0  0  0  0  0  0  0  0  0  0  0  10  10  10  10  0  0  0  0  0  0  0  0  0  0  0  0  21  21  21  21  10  21  21  21  10  10  10  10  10  10  10  10  10  10  10  10  10  10  10  10  10  0  0  0  0  0  0  0  0  0  0  0  0  0 
 0  0  0  0  10  10  10  21  21  21  10  10  10  10  10  10  0  0  0  0  0  0  0  0  0  10  10  10  10  10  0  0  0  0  0  0  0  0  0  0  0  21  21  21  10  10  10  21  21  21  21  10  10  10  10  10  10  10  10  10  10  10  10  10  10  10  10  0  0  0  0  0  0  0  0  0  0  0  0  0 
 0  0  0  0  10  21  21  21  21  21  10  10  10  10  10  10  10  10  0  0  0  0  0  0  10  10  10  10  10  10  0  0  0  0  0  0  0  0  0  0  0  21  21  21  0  10  21  21  21  21  21  10  10  10  10  10  10  10  10  10  10  10  10  10  10  10  10  0  0  0  0  0  0  0  0  0  0  0  0  0 
 0  0  0  0  10  21  21  21  21  21  21  10  10  10  10  10  10  10  10  0  0  0  0  10  10  10  10  10  10  10  0  0  0  0  0  0  0  0  0  0  0  21  21  21  0  10  21  21  21  21  21  10  10  10  10  10  10  10  10  10  10  10  10  10  10  10  10  0  0  0  0  0  0  0  0  0  0  0  0  0 
 0  0  0  0  21  21  21  21  21  21  21  10  10  10  10  10  10  10  10  10  10  10  10  10  10  10  10  10  10  10  0  0  0  0  0  0  0  0  0  0  0  21  21  21  21  10  0  0  0  0  0  10  10  10  10  10  10  10  10  10  10  10  10  10  10  10  10  0  0  0  0  0  0  0  0  0  0  0  0  0 
 0  0  0  0  21  21  21  21  21  21  21  10  10  10  10  10  10  10  10  10  10  10  10  10  10  10  10  10  10  10  0  0  0  0  0  0  0  0  0  0  0  21  21  21  21  0  0  0  0  0  0  0  10  10  10  10  10  10  10  10  10  10  10  10  10  10  10  0  0  21  0  0  0  0  0  0  0  0  0  0 
 0  0  0  0  21  21  21  21  21  21  21  21  10  10  10  10  10  10  10  10  10  10  10  10  10  10  10  10  10  10  0  0  0  0  0  0  0  0  0  0  0  21  21  10  10  0  0  0  0  0  0  0  10  10  10  10  10  10  10  10  10  10  10  10  10  10  10  21  21  21  0  0  0  0  0  0  0  0  0  0 
 0  0  0  0  0  0  0  0  0  0  21  21  10  10  10  10  10  10  10  10  10  10  10  10  10  10  10  10  10  10  0  0  0  0  0  0  0  0  0  0  10  10  0  10  10  0  0  0  0  0  0  0  0  0  0  0  10  10  10  10  10  10  10  10  10  10  10  21  21  21  0  0  0  0  0  0  0  0  0  0 
 0  0  0  0  0  0  0  0  0  0  0  21  10  10  10  10  10  10  10  10  10  10  10  10  10  10  10  10  10  10  0  0  0  0  0  0  0  0  0  0  10  10  0  10  10  0  0  0  0  0  0  0  0  0  0  0  10  10  10  10  10  10  10  10  10  10  10  10  21  21  0  0  0  0  0  0  0  0  0  0 
 0  0  0  0  0  0  0  0  0  0  0  21  10  10  10  10  10  10  10  10  10  10  10  10  10  10  10  10  10  10  10  0  0  0  0  0  0  0  0  0  0  10  0  10  10  0  0  0  0  0  0  0  0  0  0  0  10  10  10  10  10  10  10  10  10  10  10  10  21  21  21  0  0  0  0  0  0  0  0  0 
 0  0  0  0  0  0  0  0  0  0  0  0  0  0  0  0  0  0  0  0  0  0  0  0  0  0  0  0  0  0  0  0  0  0  0  0  0  0  0  0  0  0  0  0  0  0  0  0  0  0  0  0  0  0  0  0  0  0  0  0  0  0  0  0  0  0  0  0  0  0  0  0  0  0  0  0  0  0  0  0 
 0  0  0  0  0  0  0  0  0  0  0  0  0  0  0  0  0  0  0  0  0  0  0  0  0  0  0  0  0  0  0  0  0  0  0  0  0  0  0  0  0  0  0  0  0  0  0  0  0  0  0  0  0  0  0  0  0  0  0  0  0  0  0  0  0  0  0  0  0  0  0  0  0  0  0  0  0  0  0  0 
 0  0  0  0  0  0  0  0  0  0  0  0  0  0  0  0  0  0  0  0  0  0  0  0  0  0  0  0  0  0  0  0  0  0  0  0  0  0  0  0  0  0  0  0  0  0  0  0  0  0  0  0  0  0  0  0  0  0  0  0  0  0  0  0  0  0  0  0  0  0  0  0  0  0  0  0  0  0  0  0 
