80 60
63 4
0  0  0  0  0  0  0  0  0  0  0  0  0  0  0  0  0  0  0  0  0  0  0  0  0  0  0  0  0  0  0  0  0  0  0  0  0  0  0  0  0  0  0  0  0  0  0  0  0  0  0  0  0  0  0  0  0  0  0  0  0  0  0  0  0  0  0  0  0  0  0  0  0  0  0  0  0  0  0  0 
 0  0  0  0  0  0  0  0  0  0  0  0  0  0  0  0  0  0  0  0  0  0  0  0  0  0  0  0  0  0  0  0  0  0  0  0  0  0  0  0  0  0  0  0  0  0  0  0  0  0  0  0  0  0  0  0  0  0  0  0  0  0  0  0  0  0  0  0  0  0  0  0  0  0  0  0  0  0  0  0 
 0  0  0  0  0  0  0  0  0  0  0  0  0  0  0  0  0  0  0  0  0  0  0  0  0  0  0  0  0  0  0  0  0  0  0  0  0  0  0  0  0  0  0  0  0  0  0  0  0  0  0  0  0  0  0  0  0  0  0  0  0  0  0  0  0  0  0  0  0  0  0  0  0  0  0  0  0  0  0  0 
 0  0  0  0  0  0  0  0  0  0  0  0  0  0  0  0  0  0  0  0  0  0  0  0  0  0  0  0  0  0  0  10  10  10  10  10  10  10  10  10  10  10  10  10  10  10  10  10  10  10  10  10  10  10  10  10  10  10  10  10  10  10  10  10  10  10  10  0  0  0  0  0  0  0  0  0  0  0  0  0 
 0  0  0  0  0  0  0  0  0  0  0  0  0  0  0  0  0  0  0  0  0  0  0  0  0  0  0  0  0  0  21  21  21  10  10  10  10  10  10  12  0  10  10  10  10  10  12  12  10  10  10  10  10  10  10  10  10  10  10  10  10  10  10  15  15  15  10  0  0  0  0  0  0  0  0  0  0  0  0  0 
 0  0  0  0  0  0  0  0  0  0  0  0  0  0  0  0  0  0  0  0  0  0  0  0  0  0  0  0  0  21  21  21  21  10  10  10  10  10  10  10  10  0  10  10  10  10  12  12  10  10  10  10  10  10  10  10  10  10  10  10  10  10  10  15  15  15  10  0  0  0  0  0  0  0  0  0  0  0  0  0 
 0  0  0  0  0  0  0  0  0  0  0  0  0  0  0  0  0  0  0  0  0  0  0  0  0  0  0  0  0  21  21  21  21  10  10  10  10  10  10  10  10  10  10  10  10  10  10  10  10  10  10  10  10  10  10  10  10  10  10  10  10  10  10  10  10  10  10  10  10  0  0  0  0  0  0  0  0  0  0  0 
 0  0  0  0  0  0  0  0  0  0  0  0  0  0  0  0  0  0  0  0  0  0  0  0  0  0  0  0  0  21  10  21  21  10  10  12  10  10  10  10  10  10  10  10  10  12  12  10  10  10  10  10  10  10  10  10  10  10  10  12  12  10  10  10  10  10  10  10  10  0  0  0  0  0  0  0  0  0  0  0 
 0  0  0  0  0  0  0  0  0  0  0  0  0  0  0  0  0  0  0  0  0  0  0  0  0  0  0  0  0  21  10  21  10  10  10  10  10  10  10  10  10  12  10  10  0  10  10  10  10  10  10  10  10  10  10  10  10  10  10  12  12  10  10  10  10  0  10  10  10  0  0  0  0  0  0  0  0  0  0  0 
 0  0  0  0  0  0  0  0  0  0  0  0  0  0  0  0  0  0  0  0  0  0  0  0  0  0  0  0  0  21  10  10  10  10  10  12  12  10  10  10  10  10  10  10  10  10  10  10  10  10  10  10  10  10  10  10  10  10  10  10  10  10  10  10  10  10  10  10  10  0  0  0  0  0  0  0  0  0  0  0 
 0  0  0  0  0  0  0  0  0  0  0  0  0  0  0  0  0  0  0  0  0  0  0  0  0  0  0  0  0  21  10  10  10  10  10  12  12  10  10  10  10  10  10  10  10  10  10  10  10  10  10  10  10  10  10  10  10  10  10  10  10  10  10  10  0  10  10  10  10  0  0  0  0  0  0  0  0  0  0  0 
 0  0  0  0  0  0  0  0  0  0  0  0  0  0  0  0  0  0  0  0  0  0  0  0  0  0  0  0  21  21  10  10  10  10  10  0  10  10  10  10  10  10  10  10  10  10  10  10  10  10  10  12  10  10  10  10  10  10  10  0  10  10  10  10  10  10  10  10  0  0  0  0  0  0  0  0  0  0  0  0 
 0  0  0  0  0  0  0  0  0  0  0  0  0  0  0  0  0  0  0  0  0  0  0  0  0  0  0  0  21  0  10  10  10  10  12  10  10  10  10  10  10  10  10  10  10  10  10  10  10  10  10  10  10  10  10  10  10  10  0  10  10  10  10  10  12  10  10  10  0  0  0  0  0  0  0  0  0  0  0  0 
 0  0  0  0  0  0  0  0  0  0  0  0  0  0  0  0  0  0  0  0  0  0  0  0  0  0  0  21  21  0  10  10  10  10  10  10  10  10  10  10  10  10  10  10  12  10  10  10  10  10  10  10  10  10  12  12  10  10  10  10  10  10  10  10  10  10  10  10  0  0  0  0  0  0  0  0  0  0  0  0 
 0  0  0  0  0  0  0  0  0  0  0  0  0  0  0  0  0  0  0  0  0  0  0  0  0  0  10  21  10  10  10  10  10  10  10  10  10  10  10  10  10  10  10  10  12  10  10  10  10  10  10  10  10  10  12  12  10  10  12  10  10  10  10  10  10  10  10  10  0  0  0  0  0  0  0  0  0  0  0  0 
 0  0  0  0  0  0  0  0  0  0  0  0  0  0  0  0  0  0  0  0  0  0  0  0  0  0  10  21  10  10  10  10  10  10  10  10  10  10  0  10  10  10  10  10  10  10  10  10  10  10  10  10  10  10  10  10  10  10  10  10  10  10  10  10  21  21  21  21  0  0  0  0  0  0  0  0  0  0  0  0 
 0  0  0  0  0  0  0  0  0  0  0  0  0  0  0  0  0  0  0  0  0  0  0  0  0  0  10  0  10  10  10  10  10  10  10  10  12  12  10  0  10  10  10  10  10  10  10  10  10  10  10  10  10  10  10  10  10  10  10  10  10  10  10  21  21  21  21  21  0  0  0  0  0  0  0  0  0  0  0  0 
 0  0  0  0  0  0  0  0  0  0  0  0  0  0  0  0  0  0  0  0  0  0  0  10  10  10  10  0  10  10  10  10  10  10  10  10  10  10  10  10  10  10  10  10  10  10  12  10  10  10  10  10  10  12  10  10  10  10  10  10  12  12  10  21  21  21  21  21  0  0  0  0  0  0  0  0  0  0  0  0 
 0  0  0  0  0  0  0  0  0  0  0  0  0  0  0  0  0  0  0  0  0  0  0  10  10  10  10  10  10  10  10  10  10  10  10  10  10  10  10  10  10  10  10  10  10  10  10  0  12  12  10  10  10  10  10  10  10  10  10  10  12  12  10  21  21  21  21  21  0  0  0  0  0  0  0  0  0  0  0  0 
 0  0  0  0  0  0  0  0  0  0  0  0  0  0  0  0  0  0  0  0  0  0  0  21  10  10  10  10  10  10  10  10  10  10  10  12  10  10  10  10  10  10  10  10  10  10  10  10  12  12  10  10  10  10  10  10  10  10  10  10  10  10  10  21  21  21  21  21  0  0  0  0  0  0  0  0  0  0  0  0 
 0  0  0  0  0  0  0  0  0  0  0  0  0  0  0  0  0  0  0  0  0  0  21  0  10  10  10  10  10  10  0  10  10  10  10  10  10  10  10  10  10  10  10  10  10  10  10  10  10  10  10  10  10  10  10  12  12  10  10  10  10  10  10  21  21  21  21  21  0  0  0  0  0  0  0  0  0  0  0  0 
 0  0  0  0  0  0  0  0  0  0  0  0  0  0  0  0  0  0  0  0  0  21  21  21  0  10  10  10  10  10  10  10  10  10  10  10  10  10  10  10  10  10  10  10  10  10  10  10  10  10  10  10  10  10  10  12  12  10  10  10  10  10  10  10  21  21  10  10  0  0  0  0  0  0  0  0  0  0  0  0 
 0  0  0  0  0  0  0  0  0  0  0  0  0  0  0  0  0  0  0  0  0  21  21  21  10  0  10  10  10  10  10  10  10  10  10  10  10  12  10  10  12  12  10  10  10  10  10  10  10  10  10  10  10  10  10  10  10  10  10  10  10  10  10  10  21  21  10  10  0  0  0  0  0  0  0  0  0  0  0  0 
 0  0  0  0  0  0  0  0  0  0  0  0  0  0  0  0  0  0  0  0  0  21  21  21  10  10  0  10  10  10  10  10  10  10  10  10  10  10  10  10  12  12  10  10  10  10  10  10  10  0  10  10  10  10  10  10  10  10  10  10  10  10  10  10  21  21  10  10  0  0  0  0  0  0  0  0  0  0  0  0 
 0  0  0  0  0  0  0  0  0  0  0  0  0  0  0  0  0  0  0  0  0  0  10  21  10  10  10  0  10  10  10  10  10  10  10  0  10  10  10  10  10  10  10  10  10  10  10  10  10  12  10  10  10  10  10  10  10  10  0  10  10  21  21  21  21  21  0  10  0  0  0  0  0  0  0  0  0  0  0  0 
 0  0  0  0  0  0  0  0  0  0  0  0  0  0  0  0  0  0  0  21  21  0  10  10  10  10  10  10  0  10  10  10  10  10  10  10  10  10  10  10  10  10  10  12  10  10  10  10  10  10  10  10  10  0  0  0  10  10  10  10  10  21  21  21  21  21  0  10  0  0  0  0  0  0  0  0  0  0  0  0 
 0  0  0  0  0  0  0  0  0  0  0  0  0  0  0  0  0  0  0  21  21  10  10  10  10  10  10  10  10  0  10  10  10  10  10  10  10  10  10  10  10  10  10  12  10  10  10  10  10  10  10  10  10  0  0  0  10  10  10  10  10  21  21  21  21  21  21  10  10  0  0  0  0  0  0  0  0  0  0  0 
 0  0  0  0  0  0  0  0  0  0  0  0  0  0  0  0  0  0  21  21  21  10  10  10  10  10  10  10  10  0  10  10  10  10  10  10  10  10  10  10  10  10  10  10  10  10  10  10  10  10  10  10  10  0  0  0  10  10  10  10  10  10  21  21  21  21  10  10  10  0  0  0  0  0  0  0  0  0  0  0 
 0  0  0  0  0  0  0  0  0  0  0  0  0  0  0  0  0  0  21  21  21  10  10  10  10  10  10  10  0  10  10  10  10  10  10  10  10  10  12  12  10  10  10  10  10  10  10  10  10  10  10  10  10  10  10  10  10  10  10  10  10  10  21  21  10  10  10  21  21  0  0  0  0  0  0  0  0  0  0  0 
 0  0  0  0  0  0  0  0  0  0  0  0  0  0  0  0  0  21  21  0  10  10  10  10  10  10  10  0  10  10  10  10  10  10  10  10  10  10  12  12  10  10  10  10  12  10  10  10  10  10  10  10  10  10  10  10  10  10  10  10  10  10  21  21  10  10  21  21  21  0  0  0  0  0  0  0  0  0  0  0 
 0  0  0  0  0  0  0  0  0  0  0  0  0  0  0  0  21  21  21  0  10  10  10  10  10  10  10  10  10  10  10  10  0  10  10  10  10  10  10  10  10  10  10  10  10  10  10  10  10  10  10  10  10  10  10  10  10  10  10  10  10  12  21  21  10  21  21  21  21  21  0  0  0  0  0  0  0  0  0  0 
 0  0  0  0  0  0  0  0  0  0  0  0  0  0  0  0  21  21  21  0  10  10  10  10  10  10  10  10  10  10  10  0  10  0  10  10  10  10  10  10  10  10  0  10  10  10  10  10  10  10  10  10  12  10  10  10  10  10  10  10  10  10  21  21  10  21  21  21  21  21  0  0  0  0  0  0  0  0  0  0 
 0  0  0  0  0  0  0  0  0  0  0  0  0  0  0  0  21  10  10  10  10  10  10  10  10  10  10  10  10  10  0  10  10  10  0  10  10  10  10  10  10  10  10  10  10  10  10  10  10  10  10  10  10  10  10  10  10  10  10  10  10  10  0  10  10  21  21  21  21  21  0  0  0  0  0  0  0  0  0  0 
 0  0  0  0  0  0  0  0  0  0  0  0  0  0  0  10  21  10  0  10  10  10  10  10  10  10  10  10  10  0  10  0  10  10  10  0  10  10  10  10  10  10  0  10  10  10  10  10  10  10  10  10  10  10  12  12  10  10  10  10  10  10  0  10  10  10  21  21  21  21  0  0  0  0  0  0  0  0  0  0 
 0  0  0  0  0  0  0  0  0  0  0  0  0  0  10  10  0  10  10  10  10  10  10  10  10  10  10  10  10  10  10  10  10  10  10  0  10  10  10  10  10  10  10  10  10  12  12  10  10  10  10  10  10  10  12  12  10  10  10  10  10  10  10  10  10  10  10  21  21  21  0  0  0  0  0  0  0  0  0  0 
 0  0  0  0  0  0  0  0  0  0  0  0  0  10  10  10  0  10  10  10  10  10  10  10  10  10  10  10  10  10  10  10  10  10  0  10  10  10  10  10  10  10  10  10  10  10  10  10  10  10  0  10  10  10  10  10  10  10  10  10  0  0  10  10  10  10  10  0  21  0  0  0  0  0  0  0  0  0  0  0 
 0  0  0  0  0  0  0  0  0  0  0  0  10  10  10  10  0  10  10  10  10  10  10  10  10  10  10  10  10  10  10  10  10  0  10  10  10  10  0  10  10  10  10  10  10  10  10  10  10  10  12  10  10  10  10  10  10  10  10  0  0  0  21  10  10  21  10  0  21  0  0  0  0  0  0  0  0  0  0  0 
 0  0  0  0  0  0  0  0  0  0  0  0  10  10  10  10  10  10  10  10  10  10  10  10  10  10  10  10  10  10  10  10  10  10  10  10  10  0  10  0  10  10  10  10  10  10  10  10  10  10  10  10  10  10  10  10  10  10  10  0  0  0  21  21  21  21  10  10  21  0  0  0  0  0  0  0  0  0  0  0 
 0  0  0  0  0  0  0  0  0  0  0  0  10  10  10  10  10  10  10  10  10  10  10  10  10  10  10  10  10  10  10  10  10  0  10  10  0  21  21  21  0  10  10  10  10  10  10  10  10  10  10  10  10  0  10  10  10  10  10  10  21  21  21  21  21  21  10  10  10  0  0  0  0  0  0  0  0  0  0  0 
 0  0  0  0  0  0  0  0  0  0  0  21  10  10  10  10  10  10  10  10  10  10  10  10  10  10  10  10  10  10  10  10  10  10  10  10  10  21  21  21  21  0  10  10  10  10  10  10  10  10  10  10  12  0  10  10  10  10  10  21  21  21  21  21  21  21  10  10  0  0  0  0  0  0  0  0  0  0  0  0 
 0  0  0  0  0  0  0  0  0  21  21  21  21  10  10  10  10  10  10  10  10  10  10  10  10  10  10  10  10  10  10  10  10  10  10  10  10  21  21  21  21  21  0  10  10  10  10  12  10  10  10  10  10  10  10  10  10  10  21  21  21  21  21  21  21  10  10  10  0  0  0  0  0  0  0  0  0  0  0  0 
 0  0  0  0  0  0  0  0  0  21  21  21  10  10  10  10  10  10  10  10  10  10  10  10  10  10  10  10  10  10  10  10  10  10  10  10  21  10  21  10  21  21  10  0  10  10  10  10  10  10  10  10  10  21  21  21  21  21  21  21  21  21  21  21  21  10  10  0  0  0  0  0  0  0  0  0  0  0  0  0 
 0  0  0  0  0  0  0  0  0  0  21  21  10  10  10  10  10  10  10  10  10  10  10  10  10  10  10  10  10  10  10  10  10  10  10  10  10  10  21  10  21  21  10  10  0  10  10  10  10  10  10  10  21  21  21  21  21  21  21  21  21  12  21  21  10  10  10  0  0  0  0  0  0  0  0  0  0  0  0  0 
 0  0  0  0  0  0  0  0  0  0  10  10  10  10  10  10  10  10  10  10  10  10  10  10  10  21  10  10  10  10  10  10  10  10  10  10  10  10  21  10  21  21  10  10  10  0  10  10  10  10  10  10  21  21  21  21  21  21  10  21  21  12  21  21  10  10  10  0  0  0  0  0  0  0  0  0  0  0  0  0 
 0  0  0  0  0  0  0  21  21  10  10  10  10  10  10  10  10  10  10  10  10  10  10  10  10  21  21  10  10  10  10  10  10  10  10  10  10  10  21  10  10  10  10  10  21  21  0  10  10  10  10  10  10  21  21  21  21  10  10  10  21  10  10  0  10  10  10  0  0  0  0  0  0  0  0  0  0  0  0  0 
 0  0  0  0  0  0  0  21  0  10  10  10  10  10  10  10  10  10  10  10  10  21  21  10  10  21  21  10  10  10  10  10  10  10  10  10  10  10  21  10  10  10  10  21  21  21  21  0  10  10  10  10  10  21  10  21  10  10  10  10  0  10  10  0  10  10  0  0  0  0  0  0  0  0  0  0  0  0  0  0 
 0  0  0  0  0  0  0  21  0  10  10  10  10  10  10  10  10  10  10  10  21  21  21  10  10  21  21  21  10  21  21  10  10  10  10  10  10  10  0  10  10  10  10  21  21  21  21  0  10  10  10  10  10  21  21  12  12  10  10  10  0  10  10  10  10  0  0  0  0  0  0  0  0  0  0  0  0  0  0  0 
 0  0  0  0  0  0  10  21  0  10  10  10  10  10  10  10  10  10  10  10  21  21  21  10  10  0  0  10  21  21  21  10  10  10  10  10  10  10  0  10  10  10  10  21  21  21  21  10  0  10  10  10  10  21  21  12  12  10  10  10  10  10  10  10  0  0  0  0  0  0  0  0  0  0  0  0  0  0  0  0 
 0  0  0  0  0  10  10  0  10  10  10  10  10  10  10  10  10  10  10  10  10  21  21  21  0  0  0  0  10  21  21  10  10  10  10  10  10  10  10  10  10  10  10  21  21  21  10  10  10  0  10  10  10  21  21  10  10  10  10  10  10  10  10  0  0  0  0  0  0  0  0  0  0  0  0  0  0  0  0  0 
 0  0  0  0  10  10  10  0  10  10  10  10  10  10  10  10  10  10  10  10  10  21  0  0  0  0  0  0  0  0  0  10  10  10  10  10  0  0  0  0  10  10  10  10  10  21  10  10  10  10  0  10  10  21  0  10  10  10  10  10  10  0  0  0  0  0  0  0  0  0  0  0  0  0  0  0  0  0  0  0 
 0  0  0  0  10  10  10  0  10  10  10  10  10  10  10  10  10  10  10  10  10  0  0  0  0  0  0  0  0  0  0  10  10  10  10  0  0  0  0  0  0  10  10  10  10  21  10  10  10  10  10  0  10  10  0  10  10  0  0  0  0  0  0  0  0  0  0  0  0  0  0  0  0  0  0  0  0  0  0  0 
 0  0  0  0  10  10  10  10  10  10  10  10  10  10  10  10  10  10  10  10  10  0  0  0  0  0  0  0  0  0  0  10  10  10  0  0  0  0  0  0  0  0  10  10  10  0  10  10  10  10  10  10  0  10  0  0  0  0  0  0  0  0  0  0  0  0  0  0  0  0  0  0  0  0  0  0  0  0  0  0 
 0  0  0  0  10  10  10  10  10  10  10  10  10  10  10  10  10  10  10  10  10  0  0  0  0  0  0  0  0  0  0  10  10  0  0  0  0  0  0  0  0  0  0  10  10  0  10  10  10  0  0  0  0  0  0  0  0  0  0  0  0  0  0  0  0  0  0  0  0  0  0  0  0  0  0  0  0  0  0  0 
 0  0  0  0  10  35  35  10  10  10  10  10  10  10  10  10  10  10  10  10  10  10  10  0  0  0  0  0  0  10  10  10  10  0  0  0  0  0  0  0  0  0  0  0  0  0  0  0  0  0  0  0  0  0  0  0  0  0  0  0  0  0  0  0  0  0  0  0  0  0  0  0  0  0  0  0  0  0  0  0 
 0  0  0  0  10  35  35  10  10  10  10  10  10  10  10  10  10  10  10  10  10  10  10  10  0  0  0  0  10  10  10  0  0  0  0  0  0  0  0  0  0  0  0  0  0  0  0  0  0  0  0  0  0  0  0  0  0  0  0  0  0  0  0  0  0  0  0  0  0  0  0  0  0  0  0  0  0  0  0  0 
 0  0  0  0  10  35  35  10  10  10  10  10  10  10  10  10  10  10  10  10  10  10  10  10  10  0  0  10  10  0  0  0  0  0  0  0  0  0  0  0  0  0  0  0  0  0  0  0  0  0  0  0  0  0  0  0  0  0  0  0  0  0  0  0  0  0  0  0  0  0  0  0  0  0  0  0  0  0  0  0 
 0  0  0  0  10  10  10  10  10  10  10  10  10  10  10  10  10  10  10  10  10  10  10  10  10  10  10  10  0  0  0  0  0  0  0  0  0  0  0  0  0  0  0  0  0  0  0  0  0  0  0  0  0  0  0  0  0  0  0  0  0  0  0  0  0  0  0  0  0  0  0  0  0  0  0  0  0  0  0  0 
 0  0  0  0  0  0  0  0  0  0  0  0  0  0  0  0  0  0  0  0  0  0  0  0  0  0  0  0  0  0  0  0  0  0  0  0  0  0  0  0  0  0  0  0  0  0  0  0  0  0  0  0  0  0  0  0  0  0  0  0  0  0  0  0  0  0  0  0  0  0  0  0  0  0  0  0  0  0  0  0 
 0  0  0  0  0  0  0  0  0  0  0  0  0  0  0  0  0  0  0  0  0  0  0  0  0  0  0  0  0  0  0  0  0  0  0  0  0  0  0  0  0  0  0  0  0  0  0  0  0  0  0  0  0  0  0  0  0  0  0  0  0  0  0  0  0  0  0  0  0  0  0  0  0  0  0  0  0  0  0  0 
 0  0  0  0  0  0  0  0  0  0  0  0  0  0  0  0  0  0  0  0  0  0  0  0  0  0  0  0  0  0  0  0  0  0  0  0  0  0  0  0  0  0  0  0  0  0  0  0  0  0  0  0  0  0  0  0  0  0  0  0  0  0  0  0  0  0  0  0  0  0  0  0  0  0  0  0  0  0  0  0 